111111111111111111111111111111111111111111
11P00000000111111110000000000XXXXXX00000C1
11111111110111111100C000XXXXXX1111XXXXX001
100000000000000C100000XXX1111111111111X001
1111011111111111110000X1111111E0011111XX01
1000000000000000000000XXXXX111110001111X01
101111000C0000111100000000XXXX11110111XX01
100011110000111111100000000000XXXX0XXXX001
1110110000000111110000000000CC000000000001
111011111100000000000C00000000000000000001
11001111111000000000000000000000000CC00001
110CXC111111110000000000000111111000000001
111110000111111000000001111111111110000001
100000001111110000000000111111111000C00111
101111111111100C00111000001111100000111111
100000000000000000111111100000000000011111
100000000000000011111111000000000000000001
10000C001111100000011000000000111100000C01
100111111111111100000000011111111111110001
1000011111111110000000011111110000C1111001
100000001111111001111100111110011111100001
101110000000000000111000000110110000000001
111111110000C00001111110000000000000011111
111111111100000111111111000000000111111111
111111111111111111111111111111111111111111