1111111111111111111111111
10010000001C11C0001X0E0X1
10X101CC10001111001X000X1
1000011110001CC1100XX0XX1
10P000XX00000000000000001
1110000000010000010010101
1X101100C0010X1X011110101
1000110000010X1X01CC1C1X1
1110110111111000000011111
100001111000100000X0000X1
1000010110X0111001CCC1011
101100C10000000001CCC1CX1
1111111111111111111111111